NO ./assets/textures/n_wall.xpm42
WE ./assets/textures/w_wall.xpm42
EA ./assets/textures/e_wall.xpm42

F 254,100,0
C 225,30,0

111111111111
100001 0N111
111111111111
