NA ./assets/textures/n_wall.xpm42
WE ./assets/textures/w_wall.xpm42
EA ./assets/textures/e_wall.xpm42
SO ./assets/textures/s_wall.xpm42

F 250,100,0

111111111111
10000000N111
111111111111
