NO ./assets/textures/n_wall.xpm42


                        EA                      ./assets/textures/e_wall.xpm42



        SO ./assets/textures/s_wall.xpm42









                WE                                                              ./assets/textures/w_wall.xpm42





C                55     ,185,255





F 0,65,10

        1111111111111111111111111
        1000000000110000000000001
        1011000001110000000000001
        1001000000000000000000001
111111111011000001110000000000001
100000000011000001110111111111111
11110111111111011100000000001
11110111111111011101010010001
11000000110101011100000010001
10000000000000001100000010001
1000S000000000001101010010001
11000001110101011111011110001
11110111 1110101 101111010001
11111111 1111111 111111111111
