NO ./assets/textures/n_wall.xpm42
EA ./assets/textures/e_wall.xpm42
SO ./assets/textures/s_wall.xpm42
WE ./assets/textures/w_wall.xpm42

C 255,185,255
F 60,35,10

111111111
1000N0111
100000001
100000001
100000001
100000001
111111111
