111111111111111
101000010000001
101000010000001
100000000011001
100000010011001
10000001000N001
100001010000001
111111111111111
