1111111111111111111111111
1000000000110000000000001
1011000001110000000000001
1001000000000000000000001
1111111110110000011100001
1000000000110000011101111
1111011111111101110000001
1111011111111101110101001
1000000000000000110000001
1000000000000000110101001
1100000111010101111100001
1111011111101011000111001
1111111111111111111111111
