111111111111111111111111111111111111111111111111111111111111111111111111111
100000000000001100000000000001100000000000001100000000000001100000000000001
100000000000001100000000000001100000000000001100000000000001100000000000001
100000000011001100000000000001100000000000001100000000000001100000000000001
100000000011001100000000000001100000000000001100000000000001100000000000001
100000000000001100000000000001100000000000001100000000000001100000000000001
100000000000000000000000000000000000000000000000000000000000000000000000001
100000000000000000000000000000000000000000000000000000000000000000000000001
100000000000000000000000000000000000000000000000000000000000000000000000001
100000000000000000000000000000000000000000000000000000000000000000000000001
100000000000000000000000000000000000000000000000000000000000000000000000001
100000000000000000000000000000000000000000000000000000000000000000000000001
100000000000000000000000000000000000000000000001100000000000000000000000001
100000000000000000000000000000000000000000000001100000000000000000000000001
100000000000000000000000000000000000000000000001100000000000000000000000001
100000000000000000000000111000000000000000000001100000000000000000000000001
100000000001000000000000111000000000000000000000000000000000000110000000001
100000000111000000000000111000000000000000000000000000000000001100000000001
100000000110000000000000000000000000000000000000000000000000000000000000001
100000000000000000000000000000000000000000000000000001111111110000000000001
100000000000000000000000000000000000000000000000000000000000000000000000001
100000000000000000000000000000000000000000000000000000000000000000000000001
100000000000000000000000000000000000000000000000000000000000000000000000001
100000000000000000000000000000000000000000000000000000000000000000000000001
100000000000000000000000000000000000000000000000000000000000000000000000001
111111111111111111111111111111111111111111111111111111111111111111111111111
