111111111111111
1N1000010000001
101000010000001
100000000011001
100000010011001
100000010000001
100001010000001
111111111111111
